1111111111
1CC011E001
1CC0P00001
1111111111